10000000000000000000000000000000000000000000000000000000000000000000000000000000000001
00100000000000000000000000000000000000000000000000000000000000000000000000000000000100
00001111111111111111111111111111111111111111111111111111111111111111111111111111111000
00001000000000000000000000000000000000000000000000000000000000000000000000000000001000
00001000000000000000000000000000000000000000000000000000000000000000000000000000001000
00001000000000000000000000000000000000000000000000000000000000000000000000000000001000
00001000000000000000000000000000000000000000000000000000000000000000000000000000001000
00001000000000000000000000000000000000000000000000000000000000000000000000000000001000
00001000000000000000000000000000000000000000000000000000000000000000000000000000001000
00001000000000000000000000000000000000000000000000000000000000000000000000000000001000
00001000000000000000000000000000000000000000000000000000000000000000000000000000001000
00001000000000000000000000000000000000000000000000000000000000000000000000000000001000
00001000000000000000000000000000000000000000000000000000000000000000000000000000001000
00001000000000000000000000000000000000000000000000000000000000000000000000000000001000
00001000000000000000000000000000000000000000000000000000000000000000000000000000001000
00001000000000000000000000000000000000000000000000000000000000000000000000000000001000
00001000000000000000000000000000000000000000000000000000000000000000000000000000001000
00001000000000000000000000000000000000000000000000000000000000000000000000000000001000
00001000000000000000000000000000000000000000000000000000000000000000000000000000001000
00001000000000000000000000000000000000000000000000000000000000000000000000000000001000
00001000000000000000000000000000000000000000000000000000000000000000000000000000001000
00001000000000000000000000000000000000000000000000000000000000000000000000000000001000
00001000000000000000000000000000000000000000000000000000000000000000000000000000001000
00001000000000000000000000000000000000000000000000000000000000000000000000000000001000
00021000000000000000000000000000000000000000000000000000000000000000000000000000001000
00221000000000000000000000000000000000000000000000000000000000000000000000000000001000
02221000000000000000000000000000000000000000000000000000000000000000000000000000001000
22221000002000000000000000000000000000002000000000000000000000000000000000000000001000
22331000022200000000002200000002000000022202000000022200000000000000000220000000001000
23331002222220222000222220002022220000222222200200222222200002200000002222020200201000
33331222222222222222222222222222222222222222222222222222222222222222222222222222221000
33331111111111111111111111111111111111111111111111111111111111111111111111111111111000
33122222222222222222222222222222222222222222222222222222222222222222222222222222222100
13333333333333333333333333333333333333333333333333333333333333333333333333333333333331