10000000000000000000000000000000000000000000000000000000000000000000000000000001000100
01000000000000000000000000000000000000000000000000000000000000000000000000000100000100
00100000000000000000000000000000000000000000000000000000000000000000000000010000000100
00010000000000000000000000000000000000000000000000000000000000000000000001000000000100
00001111111111111111111111111111111111111111111111111111111111111111111100000000000100
00001000000000000000000000000000000000000000000000000000000000000000000100000000000100
00001000000000000000000000000000000000000000000000000000000000000000000100000000000100
00001000000000000000000000000000000000000000000000000000000000000000000100000000000100
00001000000000000000000000000000000000000000000000000000000000000000000100000000000100
00001000000000000000000000000000000000000000000000000000000000000000000100000000000100
00001000000000000000000000000000000000000000000000000000000000000000000100000000000100
00001000000000000000000000000000000000000000000000000000000000000000000100000000000100
00001000000000000000000000000000000000000000000000000000000000000000000100000000000100
00001000000000000000000000000000000000000000000000000000000000000000000100000000000100
00001000000000000000000000000000000000000000000000000000000000000000000100000000000100
00001000000000000000000000000000000000000000000000000000000000000000000100000000000100
00001000000000000000000000000000000000000000000000000000000000000000000100000000000100
00001000000000000000000000000000000000000000000000000000000000000000000100000000000100
00001000000000000000000000000000000000000000000000000000000000000000000100000000000100
00001000000000000000000000000000000000000000000000000000000000000000000100000000000100
00001000000000000000000000000000000000000000000000000000000000000000000100000000000100
00001000000000000000000000000000000000000000000000000000000000000000000100000000000100
00001000000000000000000000000000000000000000000000000000000000000000000100000000000100
00001000000000000000000000000000000000000000000000000000000000000000000100000000000100
00001000000000000000000000000000000000000000000000000000000000000000000100000000000100
00001000000000000000000000000000000000000000000000000000000000000000000100000000000100
00001000000000000000000000000000000000000000000000000000000000000000000100000000000100
00001000000000000000000000000000000000000000000000000000000000000000000100000000000100
00001111111111111111111111111111111111111111111111111111111111111111111100000000000100
00010000000000000000000000000000000000000000000000000000000000000000000000000000000100
01000000000000000000000000000000000000000000000000000000000000000000000000000000000100
10000000000000000000000000000000000000000000000000000000000000000000000000000000000100
00000000000000000000000000000000000000000000000000000000000000000000000000000000000010
00000000000000000000000000000000000000000000000000000000000000000000000000000000000001