00000000000001000000000000000000000000000000000000000000000000000000000000000000100000
00000000000000010000000000000000000000000000000000000000000000000000000000000010000000
00000000000000000100000000000000000000000000000000000000000000000000000000001010000000
00000000000000000001000000000000000000000000000000000000000000000000000000100010000000
00000000000000000000010000000000000000000000000000000000000000000000000010000010000000
00000000000000000000000100000000000000000000000000000000000000000000001000000010000000
00000000000000000000000001000000000000000000000000000000000000000000110000000010000000
00000000000000000000000000010000000000000000000000000000000000000100010000000010000000
00000000000000000000000000000111111111111111111111111111111111100000010000000010000000
00000000000000000000000000000100000000000000000000000000000010000000010000000010000000
00000000000000000000000000000100000000000000000000000000000010000000010000000010000000
00000000000000000000000000000100000000000000000000000000000010000000010000000010000000
00000000000000000000000000000100000000000000000000000000000010000000010000000010000000
00000000000000000000000000000100000000000000000000000000000010000000010000000010000000
00000000000000000000000000000100000000000000000000000000000010000000010000000010000000
00000000000000000000000000000100000000000000000000000000000010000000010000000010000000
00000000000000000000000000000100000000000000000000000000000010000000010000000010000000
00000000000000000000000000000100000000000000000000000000000010000000010000000010000000
00000000000000000000000000000100000000000000000000000000000010000000010000000010000000
00000000000000000000000000000100000000000000000000000000000010000000010000000010000000
00000000000000000000000000000100000000000000000000000000000010000000010000000010000000
00000000000000000000000000000111111111111111111111111111111010000000010000000010000000
00000000000000000000000000010000000000000000000000000000000010000000010000000010000000
00000000000000000000000001000000000000000000000000000000000000100000010000000010000000
00000000000000000000000100000000000000000000000000000000000000001000010000000010000000
00000000000000000000001000000000000000000000000000000000000000000100010000000010000000
00000000000000000000100000000000000000000000000000000000000000000001010000000010000000
00000000000000000010000000000000000000000000000000000000000000000000010000000010000000
00000000000000011000000000000000000000000000000000000000000000000000000000000010000000
00000000000001000000000000000000000000000000000000000000000000000000000000000010000000
00000000000100000000000000000000000000000000000000000000000000000000000000000010000000
00000000010000000000000000000000000000000000000000000000000000000000000000000010000000
00000001000000000000000000000000000000000000000000000000000000000000000000000000100000
00000010000000000000000000000000000000000000000000000000000000000000000000000000010000