44444444444444444444444444444444444444444444444444444444444444444444444444444444444444
44444444444444444444444444444444444444444444444444444444444444444444444444444444444444
44444444444444444444444444444444444444444444444444444444444444444444444444444444444444
44444444444444444444444444444444444444444444444444444444444444444444444444444444444444
44444444444444444444444444444444444444444444444444444444444444444444444444444444444444
44444444444444444444444444444444444444444444444444444444444444444444444444444444444444
44444444444444444444444444444444444444444444444444444444444444444444444444444444444444
44111111111111111111111111111111111111111111111111111111111111111111111111111111111144
44100000000000000000000000000000000000000000000000000000000000000000000000000000000144
44100000000000000000000000000000000000000000000000000000000000000000000000000000000144
44100000000000000000000000000000000000000000000000000000000000000000000000000000000144
44100000000000000000000000000000000000000000000000000000000000000000000000000000000144
44100000000000000000000000000000000000000000000000000000000000000000000000000000000144
44100000000000000000000000000000000000000000000000000000000000000000000000000000000144
44100000000000000000000000000000000000000000000000000000000000000000000000000000000144
44100000000000000000000000000000000000000000000000000000000000000000000000000000000144
44100000000000000000000000000000000000000000000000000000000000000000000000000000000144
44100000000000000000000000000000000000000000000000000000000000000000000000000000000144
44100000000000000000000000000000000000000000000000000000000000000000000000000000000144
44100000000000000000000000000000000000000000000000000000000000000000000000000000000144
44100000000000000000000000000000000000000000000000000000000000000000000000000000000144
44100000000000000000000000000000000000033333333333333333333330000000000000000000000144
44100000000000000000000000222222223333333333333333333333333322222220000000000000000144
44100000000000000000002222333333333333333333333333333333333333333222000000000000000144
44100000000000000002222333333333333333333333333333333333333333333322222200000000000144
44100000000000002222333333333333333333333333333333333333333333333333333332222000000144
44100000000000222333333333333333333333333333333333333333333333333333333333222000000144
44100000022222233333333333333333333333333333333333333333333333333333333333322200000144
44100222333333333333333333333333333333333333333333333333333333333333333333322200000144
44102333333333333333333333333333333333333333333333333333333333333333333333333322000144
44122333333333333333333333333333333333333333333333333333333333333333333333333333332144
44133333333333333333333333333333333333333333333333333333333333333333333333333333333144
44133333333333333333333333333333333333333333333333333333333333333333333333333333333144
44111111111111111111111111111111111111111111111111111111111111111111111111111111111144