00100010000000000000000000000000000000000000000000000000000000000000000000000000000001
00100000100000000000000000000000000000000000000000000000000000000000000000000000000010
00100000001000000000000000000000000000000000000000000000000000000000000000000000000100
00100000000010000000000000000000000000000000000000000000000000000000000000000000001000
00100000000000111111111111111111111111111111111111111111111111111111111111111111110000
00100000000000100000000000000000000000000000000000000000000000000000000000000000010000
00100000000000100000000000000000000000000000000000000000000000000000000000000000010000
00100000000000100000000000000000000000000000000000000000000000000000000000000000010000
00100000000000100000000000000000000000000000000000000000000000000000000000000000010000
00100000000000100000000000000000000000000000000000000000000000000000000000000000010000
00100000000000100000000000000000000000000000000000000000000000000000000000000000010000
00100000000000100000000000000000000000000000000000000000000000000000000000000000010000
00100000000000100000000000000000000000000000000000000000000000000000000000000000010000
00100000000000100000000000000000000000000000000000000000000000000000000000000000010000
00100000000000100000000000000000000000000000000000000000000000000000000000000000010000
00100000000000100000000000000000000000000000000000000000000000000000000000000000010000
00100000000000100000000000000000000000000000000000000000000000000000000000000000010000
00100000000000100000000000000000000000000000000000000000000000000000000000000000010000
00100000000000100000000000000000000000000000000000000000000000000000000000000000010000
00100000000000100000000000000000000000000000000000000000000000000000000000000000010000
00100000000000100000000000000000000000000000000000000000000000000000000000000000010000
00100000000000100000000000000000000000000000000000000000000000000000000000000000010000
00100000000000100000000000000000000000000000000000000000000000000000000000000000010000
00100000000000100000000000000000000000000000000000000000000000000000000000000000010000
00100000000000100000000000000000000000000000000000000000000000000000000000000000010000
00100000000000100000000000000000000000000000000000000000000000000000000000000000010000
00100000000000100000000000000000000000000000000000000000000000000000000000000000010000
00100000000000100000000000000000000000000000000000000000000000000000000000000000010000
00100000000000111111111111111111111111111111111111111111111111111111111111111111110000
00100000000000000000000000000000000000000000000000000000000000000000000000000000001000
00100000000000000000000000000000000000000000000000000000000000000000000000000000000010
00100000000000000000000000000000000000000000000000000000000000000000000000000000000001
01000000000000000000000000000000000000000000000000000000000000000000000000000000000000
10000000000000000000000000000000000000000000000000000000000000000000000000000000000000
