00000100000000000000000000000000000000000000000000000000000000000000000000000000100000
00000001000000000000000000000000000000000000000000000000000000000000000000000010000000
00000001010000000000000000000000000000000000000000000000000000000000000000001010000000
00000001000100000000000000000000000000000000000000000000000000000000000000100010000000
00000001000001000000000000000000000000000000000000000000000000000000000010000010000000
00000001000000010000000000000000000000000000000000000000000000000000001000000010000000
00000001000000001100000000000000000000000000000000000000000000000000110000000010000000
00000001000000001000100000000000000000000000000000000000000000000100010000000010000000
00000001000000001000000111111111111111111111111111111111111111100000010000000010000000
00000001000000001000000001000000000000000000000000000000000010000000010000000010000000
00000001000000001000000001000000000000000000000000000000000010000000010000000010000000
00000001000000001000000001000000000000000000000000000000000010000000010000000010000000
00000001000000001000000001000000000000000000000000000000000010000000010000000010000000
00000001000000001000000001000000000000000000000000000000000010000000010000000010000000
00000001000000001000000001000000000000000000000000000000000010000000010000000010000000
00000001000000001000000001000000000000000000000000000000000010000000010000000010000000
00000001000000001000000001000000000000000000000000000000000010000000010000000010000000
00000001000000001000000001000000000000000000000000000000000010000000010000000010000000
00000001000000001000000001000000000000000000000000000000000010000000010000000010000000
00000001000000001000000001000000000000000000000000000000000010000000010000000010000000
00000001000000001000000001000000000000000000000000000000000010000000010000000010000000
00000001000000001000000001011111111111111111111111111111111010000000010000000010000000
00000001000000001000000001000000000000000000000000000000000010000000010000000010000000
00000001000000001000000100000000000000000000000000000000000000100000010000000010000000
00000001000000001000010000000000000000000000000000000000000000001000010000000010000000
00000001000000001000100000000000000000000000000000000000000000000100010000000010000000
00000001000000001010000000000000000000000000000000000000000000000001010000000010000000
00000001000000001000000000000000000000000000000000000000000000000000010000000010000000
00000001000000000000000000000000000000000000000000000000000000000000000000000010000000
00000001000000000000000000000000000000000000000000000000000000000000000000000010000000
00000001000000000000000000000000000000000000000000000000000000000000000000000010000000
00000001000000000000000000000000000000000000000000000000000000000000000000000010000000
00000100000000000000000000000000000000000000000000000000000000000000000000000000100000
00001000000000000000000000000000000000000000000000000000000000000000000000000000010000
