000000b00000000000011111000000000000000000000000000000a000000000000000000000000000
0000001000000100000100011111111111111110010001000111101000111111110111111111001110
0001111111111111000111110000000000000010010001000100101000100000010100000001001010
0001000000100001000100000000111111110010011111111110101000101111010101111101001010
0001111110100101111111111100100100010010010000000010101000101001010101000101001010
0000100010100101001000000100100000010010010001000010101000101001010101010101001010
0011101110111101001000111100111111111110010001000010101000101001010101010101001010
0010001000000001000000000000000100010000010001111110101000101001010101010101001010
1111111111111111111111111111111111111111110001000000101000101001010101010101001010
000001000000000100001000000010001000100001000000000000100010100c010101011101001010
0111111000010001000100000000100010001000011111111111111000101000010101000001001010
0000101111110001011111110000111111111111110000000000100011101111110101111111001010
0111101000010001010000010000000000000010010001000000100010000000000000000000001010
0100101000010001011110011111110011110010010001111111111111111111111111000010001010
0f00101011110001000000010000010010010010010001001000000000000000000001111111101010
0000111000010001111111110000010010011110010001001000000010000100001001000000101010
0111100000010000000010011111110010010010010001001000111111111110001001011110101010
0100111111111111110010010000010010010010010001001000100000000100001001010010101010
0100100000000010010010010010010010010010010001001000100010000100001001010000101010
0100100010010010010010011110011110010010010001000000100010000000001001011111101010
0100111110010010010010001000000000000000010001111111111111111000001001000000001010
0100000010010000010011111111111111111111110001000000000010001001001001111111111010
0100111111111100010010001000000000000000000001111111110010001001001001000000000010
0100100000000101110010001001111111111111000000000000010010001111001001010000000010
0111100010000101001011101001000000100000011111111111111110000100001001011111111110
0000111111100101001000101001000000100111110000000001000010000100001001000000000000
00001000100001011111111011111111101001000100d0010001000011100100001001111111111110
0111100011100100000000000000000000000100010011111001000010100111111100000010001000
01001000101001111111111111111111111111000100100000010000101001010010000100g0001000
01000000e0110000100000100000000000000000010011111111000010100101001111110000001000
00000000000000000000000000000000000000000000000000000000b0000000000000000000000000
