
00000000000000000000000000000000000000000000000000000000000000000000000000000000000000
00000000000000000000000000000000000000000000000000000000000000000000000000000000000000
00000000000000000000000000000000000000000000000000000000000000000000000000000000000000
00000000000000000000000000000000000000000000000000000000000000000000000000000000000000
00000000000000000000000000000000000000000000000000000000000000000000000000000000000000
00000000000000000000000000000000000000000000000000000000000000000000000000000000000000
00000000000000000000000000000000000000000000000000000000000000000000000000000000000000
00000000000000000000000000000000000000000000000000000000000000000000000000000000000000
00000000000000000000000000000000000000000000000000000000000000000000000000000000000000
00000000000000000000000000000000000000000000000000000000000000000001100000000000000000
00000000000000000000000000000000000000000000000000000000000000000112210000000000000000
00000000000000000000000000000000000000000000000000000000000000011222221100000000000000
00000000000000000000000000000000000000000000000000000000000011222322232210000000000000
00000000000000000000000000000000000000000000000000000000010133323332233233100000000000
00000000000000000000000000000000000000000000000000000000131133333333233333311000000000
00000000000000000000000000000000000000000000000000000001333333333333333333333111000000
00000000000000000000000000000000000000000000000000000113333333333333333333333333100000
00000000000000000000000000000000000000000000000000000133333333333333333333333333110000
00000000000000000000000000000000000000000000000000000000131133333333233333311000000000
00000000000000000000000000000000000000000000000000000001333333333333333333333111000000
00000000000000000000000000000000000000000000000000000113333333333333333333333333100000
00000000000000000000000000000000000000000000000000000133333333333333333333333333110000
00000000000000000000000000000000000000000000000000000000131133333333233333311000000000
00000000000000000000000000000000000000000000000000000001333333333333333333333111000000
00000000000000000000000000000000000000000000000000000113333333333333333333333333100000
00000000000000000000000000000000000000000000000000000133333333333333333333333333110000
00000000000000000000000000000000000000000000000000000000131133333333233333311000000000
00000000000000000000000000000000000000000000000000000001333333333333333333333111000000
00000000000000000000000000000000000000000000000000000113333333333333333333333333100000
00000000000000000000000000000000000000000000000000000133333333333333333333333333110000
00000000000000000000000000000000000000000000000000000000131133333333233333311000000000
00000000000000000000000000000000000000000000000000000001333333333333333333333111000000
00000000000000000000000000000000000000000000000000000113333333333333333333333333100000
00000000000000000000000000000000000000000000000000000133333333333333333333333333110000
