00000000000000000000000000000000000000000000000000000000000000000000000000000000000000
00000000000000000000000000000000000000000000000000000000000000000000000000000000000000
00000000000000000000000000000000000000000000000000000000000000000000000000000000000000
00000000000000000000000000000000000000000000000000000000000000000000000000000000000000
00000000000000000000000000000000000000000000000000000000000000000000000000000000000000
00000000000000000000000000000000000000000000000000000000000000000000000000000000000000
00000000000000000000000000000000000000000000000000000000000000000000000000000000000000
00000000000000000000000000000000000000000000000000000000000000000000000000000000000000
00000000000000000000000000000000000000000000000000000000000000000000000000000000000000
00000000000000000000000000000000000000000000000000000000000000000000000000000000000000
00000000000000000000000000000000000000000000000000000000000000000000000000000000000000
00000000000000000000000000000000000000000000000000000000000000000000000000000000000000
00000000000000000000000000000000000000000000000000000000000000000000000000000000000000
00000000000000000000000000000000000000000000000000000000000000000000000000000000000000
00000000000000000000000000000000000000000000000000011000000000000000000000000000000000
00000000000000000000000000000000000000000000000001122100000000000000000000000000000000
00000000000000000000000000000000000000000000001122222110000000000000000000000000000000
00000000000000000000000000000000000000000000011222222221000000000000000000000000000000
00000000000000000000000000000000000000000101222222222221000000000000000000000000000000
00000000000000000000000000000000000000000122333222222222100000000000000000000000000000
00000000000000000000000000000000000000012233333332223333221100000000000000000000000000
00000000000000000000000000000000000000122333333322233333332100000000000000000000000000
00000000000000000000000000000000000000123333333322333333333311000000000000000000000000
00000000000000000000000000000000001111333333333332333333333331110000000000000000000000
00000000000000000000000000111111113333333333333333333333333311111110000000000000000000
00000000000000000000001111333333333333333333333333333333333333333111000000000000000000
00000000000000000001111333333333333333333333333333333333333333333311111100000000000000
00000000000000001111333333333333333333333333333333333333333333333333333331111000000000
00000000000000111333333333333333333333333333333333333333333333333333333333111000000000
00000000011111133333333333333333333333333333333333333333333333333333333333311100000000
00000111333333333333333333333333333333333333333333333333333333333333333333311100000000
00001333333333333333333333333333333333333333333333333333333333333333333333333311000000
00011333333333333333333333333333333333333333333333333333333333333333333333333333331100
01333333333333333333333333333333333333333333333333333333333333333333333333333333333110
